False
#############
#         @ #
#      ######
#           #
#   h       #
#           #
#           #
#############
