True
########
#      #
#      #
#    h #
# #    #
#@     #
### ####
    
