True
#############
#      @    #
#      #    #
#           #
#    h      #
#           #
#           #
#############
