False
#############
#         @ #
#      ######
#           #
#           #
#  h        #
#           #
#############
