True
#############
#      @    #
#      ######
#           #
#           #
#           #
#           #
#    #      #
#    h      #
#############
