True
#############
#         @ #
#    h ######
#           #
#           #
#           #
#           #
#############
