True
######
#h  ##
##  ## 
##  ##
##  ##
##  ##
##  ##
##  ##
##  ##
    @
