False
########
#      #
#   h  #
#      #
# #    #
#@     #
### ####
    
