True
########
#h     #
#      #
#      #
#      #
#      #
#      #
#      #
#      #
### ####
    @
