False
#############
#       @   #
#      #    #
#           #
#    h      #
#           #
#           #
#############
