True
#############
#         @ #
#      ######
#  h        #
#           #
#           #
#           #
#############
