True
########
#@     #
##     #
#      #
#      #
#      #
#      #
#      #
#      #
###h####
   
