False
#############
#        @  #
#      ######
#           #
#   h       #
#           #
#           #
#############
