True
#############
#       @   #
#      ######
#           #
#   h       #
#           #
#           #
#############
