True
########
#      #
#     h#
#      #
# #    #
#@     #
### ####
    
