True
########
#  h   #
#      #
#      #
#      #
#      #
### ####
    @
