True
#############
#        @  #
#    h ######
#           #
#           #
#           #
#           #
#############
