True
#############
#        @  #
#      #    #
#           #
#   h       #
#           #
#           #
#############
