True
#############
#          @#
#    h ######
#           #
#           #
#           #
#           #
#############
