True
########
#   h  #
#  #   #
#      #
#      #
#      #
#  @   #
### ####
