True
########
#      #
#    h #
#      #
#      #
#  @   #
### ####
