False
########
#   h  #
#      #
#      #
#      #
#      #
### ####
    @
