True
########
#   h  #
#      #
#      #
# #    #
#@     #
### ####
    
