True
########
#      #
#      #
#      #
# #   h#
#@     #
### ####
    
